5 8
0 1
....~~~~
.#####~~
...#G.~~
.#..#.#.
........
