31 31
1 0
###############################
......#...........#.#.......#.#
#####.#.#####.###.#.#.#.###.#.#
#...#.#.#...#...#.....#...#...#
#.#.#.###.#.###.###.###########
#.#...#...#...#.#...#.......#.#
#.#####.#####.#.#.###.#####.#.#
#.....#.#...#...#...#.....#.#.#
#####.#.#.#########.#.#####.#.#
#.#...#.#...#.#...#...#...#...#
#.#.###.###.#.#.#.#####.#.#####
#.#.#...#...#...#...#...#.....#
#.#.#.###.###.#####.#.#######.#
#.#.#...#.#...#.....#.....#...#
#.#.###.#.#####.###########.###
#.......#.....#...#.#.....#.#.#
###.#####.###.###.#.#.###.#.#.#
#...#...#...#...#.#...#...#...#
#.#####.#######.#.#######.#.###
#.....#...#.......#.....#.#.#.#
#####.#.#.#.###.#######.#.#.#.#
#...#.#.#...#.....#...#.#.#.#.#
#.#.#.#.#######.#.#.#.#.#.#.#.#
#.#...#.#.#.....#.#.#.#.#.#.#.#
#.#####.#.#.#######.#.#.#.#.#.#
#.#...#.#.....#.....#.#.#.#...#
#.#.#.#.#####.#.#####.#.#.#.###
#.#.#.#...#...#.....#.#.....#.#
#.#.#.###.#.#####.#.#.###.###.#
#...#.....#.......#.#.........G
###############################
