5 8
0 1
....~~~G
.#####~~
...#G.~~
.#G.#.#.
G......G
