10 10
0 0
..~~~~~~.G
..~~~~~~..
..~~~~~~..
..~~~~~~..
..~~~~~~..
..~~~~~~..
..~~~~~~..
..~~~~~~..
..~~~~~~..
G.~~~~~~.G
