5 8
2 0
~~~~~~~~
G######G
.....#..
.######.
........
